20 20 2
W W S W W W U U U W W W W W W W U U U W
 W U U U W U U U U W W U U U W U U U U W
W U W U U W W U U U W U W U U W W U U W
 W U W U W W U U W U W U W U W W U U W W
W U W U U U U W U W U U W U U U U W U W
 W U W U W W U W U W W U W U W W U W U W
W U W U W W W U W W W U W U W W W U W W
 W U W U U W U U W W W U W U U W U U W W
W U W W U U U W U W W U W W U U U W U W
 W U U U W U U U U W W U U U W U U U U W
W W U W W W U U U W W W U W W W U U U W
 W U U U W U U U U W W U U U W U U U U W
W U W U U W W U U W W U W U U W W U U W
 W U W U W W U U W W W U W U W W U U W W
W U W U U U U W U W W U W U U U U W U W
 W U W U W W U W U W W U W U W W U W U W
W U W U W W W U W W W U U U W W W U W W
 W U W U U W U U W W W U W U U W U U W W
W U U W U U U W U W W U W W U U U W U W
 W U E U W U U U U W W U U U W U U U U W